111111111111111111111111
0                      0
0                      0
0     0                0
0     0                0
0     0                0
0     0         0      0
0     0         0      0
0     0         0      0
0               0      0
0               0      0
0               0      0
0               0      0
0               0      0
0                      0
0                      0
0                      0
0                      0
0                      0
111111111111111111111111                       